
NO ./images/north_wall.xpm


SO   ./images/south_wall.xpm

WE  ./images/west_wall.xpm


F 220,100,0
EA ./images/east_wall.xpm

C   220,100,0


     111111
     1001011111
     1010000001
     1000N11111
     11111